NO ./img_t/Wall-1.png
SO ./img_t/Wall-2.png
WE ./img_t/Wall-3.png
EA ./img_t/Wall-4.png

F 180,240,200
C 100,100,100

        1111111111111111111111111
        1000000001000000000000001
        1211000001000000000000001
        1001000001000000000000001
111111111011000000000000000000001
100000000011000000000000000111111
11110000000000000000000000001
11112111111110000000000000001
1100001     10011111111111121
10000011111110001100000000001
10000000000000000200000000001
11000001110101011111000000E01
11110001 1110101 102000000001
11111111 1111111 111111111111